0345,1,5634630,0,6436360,6540,08,0,0,0,0,0,0,0,1,1,0,0,0,7,7,7,7,7,0,0,0,0,0,0,0,0
0,1,6451,1,0,0,0,03463,0,0,4,1,2,1,2,2,1,1,2,0,7,7,1,1,2,2,1,0,0,0,0,0
2,2,1,1,2,7,0,0,0,1,3,0,0,0,2,4,2,2,1,1,2,1,1,0,0,0,0,0,0,0,0,0
2,1,1,2,7,7,0,0,1,0,0,0,0,0,0,0,0,0,0,1,1,0,2,0,1,1,0,0,5,0,0,0
0,0,2,7,7,0,0,0,0,0,0,0,0,0,1,0,0,0,0,0,0,0,1,0,0,1,2,0,0,0,0,0
0,1,1,7,0,1,3,0,0,0,0,0,1,1,1,2,4,0,0,0,1,0,1,0,6,6,4,0,0,0,0,0
0,0,1,1,0,0,0,0,4,1,1,1,2,2,2,1,0,0,0,0,2,2,2,6,2,6,6,6,7,0,0,0
0,0,2,2,0,0,0,0,0,1,0,0,1,2,2,2,2,0,0,0,0,2,6,6,6,6,6,6,6,6,0,0
0,0,2,0,4,0,0,0,1,0,0,0,0,0,2,2,2,2,2,4,0,0,1,6,6,6,6,6,6,7,0,0
0,1,0,0,0,0,0,0,0,0,0,0,0,3,0,0,2,0,0,0,0,0,2,0,6,6,2,1,2,2,2,0
0,1,0,0,0,0,5,0,0,0,1,2,0,0,0,0,1,2,0,3,0,2,0,1,0,0,0,2,1,0,0,0
0,1,0,0,1,0,0,0,0,1,0,0,0,0,1,0,0,0,0,0,1,0,0,1,1,1,0,1,0,2,0,0
0,0,1,0,0,0,0,0,0,1,0,0,1,1,2,0,0,1,2,0,1,1,0,0,0,2,0,0,0,0,0,0
0,0,0,0,0,0,0,0,0,0,0,0,1,2,0,0,0,0,0,0,0,0,0,0,0,0,0,0,0,0,0,0
0,7,5,7,0,0,3,0,1,1,4,0,0,1,1,0,0,0,0,0,1,0,0,2,2,2,1,0,5,0,1,0
0,0,7,0,0,0,0,0,1,0,0,0,2,0,1,1,0,0,0,0,0,0,1,2,0,0,4,0,0,2,0,0
2,1,2,0,0,0,0,0,0,1,0,0,0,0,0,3,0,0,0,1,0,0,4,0,0,1,2,0,2,1,0,0
2,1,2,1,0,2,4,1,0,0,0,0,0,0,7,7,7,2,2,0,0,0,0,0,0,2,2,0,2,0,0,0
2,2,1,0,0,0,1,2,2,1,0,0,1,2,7,0,0,0,1,2,0,0,0,0,0,2,0,0,1,2,0,0
2,2,2,1,4,0,2,0,0,0,0,0,0,0,0,0,1,2,0,2,0,0,3,0,0,1,0,0,0,2,0,0
2,2,2,1,0,2,1,1,0,0,0,0,0,2,1,1,2,0,1,2,0,0,0,0,1,0,0,0,0,1,1,0
2,1,2,0,0,0,2,2,1,1,1,1,0,0,1,2,0,0,2,0,0,0,2,0,0,0,0,0,0,1,2,2
1,0,1,0,0,0,0,0,0,4,0,2,0,2,0,0,1,1,1,1,0,1,0,0,1,0,0,0,0,1,2,1
0,2,2,0,5,0,0,2,1,2,0,0,1,1,1,2,0,0,1,2,0,0,0,0,0,0,0,0,0,0,1,0
0,0,0,0,0,0,0,1,1,1,0,0,1,2,3,2,1,0,1,3,2,0,0,0,0,3,0,0,0,0,0,0
0,2,0,2,2,1,0,3,2,2,0,0,1,1,0,0,0,0,0,2,0,1,1,2,1,0,7,7,1,1,0,0
0,2,2,1,1,1,1,1,1,1,0,0,0,0,0,0,0,0,0,2,0,0,0,0,0,7,7,1,2,2,2,0
0,0,2,6,6,6,6,6,1,0,4,0,0,0,0,0,0,0,0,0,0,0,0,0,7,7,2,0,2,0,1,0
0,0,6,6,6,6,6,6,6,1,0,0,1,1,1,0,0,0,0,1,3,2,0,0,7,7,0,1,2,2,0,0
0,0,7,6,6,6,6,6,6,0,0,0,1,2,1,0,0,5,0,0,0,1,2,0,0,0,0,0,2,0,0,0
0,0,0,0,6,0,6,6,0,0,0,0,2,1,1,0,0,0,0,0,0,0,2,0,0,0,0,0,0,0,0,0
0,0,0,0,0,0,0,0,0,0,0,0,0,0,0,0,0,0,0,0,0,0,0,0,0,0,0,0,0,0,0,0
